Call of Duty®: Warzone™: r/CallOfDuty
Call of Duty®: Black Ops 6: r/blackops6
Call of Duty®: r/CallOfDuty
Hearts of Iron IV: r/hoi4
Farming Simulator 25: r/farmingsimulator25
THRONE AND LIBERTY: r/throneandliberty
Counter-Strike 2: r/counterstrike2
Warframe: r/Warframe
Expansion - Hearts of Iron IV: Götterdämmerung: r/hoi4
ASTRONEER: r/Astroneer
Apex Legends™: r/apexlegends
War Thunder: r/Warthunder
Microsoft Flight Simulator 2024: r/MicrosoftFlightSim
Rust: r/rust
Enshrouded: r/Enshrouded
Baldur's Gate 3: r/BaldursGate3
Factorio: r/factorio
Warhammer 40,000: Rogue Trader: r/RogueTraderCRPG
Once Human: r/OnceHuman
HELLDIVERS™ 2: r/helldivers2
EA SPORTS FC™ 25: r/EASportsFC
Black Desert: r/blackdesert
Dead by Daylight: r/deadbydaylight
Magic: The Gathering Arena: r/MagicArena
Warhammer 40,000: Space Marine 2: r/SpaceMarine_2
DRAGON BALL: Sparking! ZERO: r/DragonBallSparking
The Elder Scrolls® Online: r/TheElderScrollsOnline
NBA 2K25: r/NBA2K25
WEBFISHING: r/webfishing
Fallout 76: r/fo76
FINAL FANTASY XIV Online: r/FinalFantasyOnline
Lost Ark: r/LostArk
Destiny 2: r/destiny2
PUBG: BATTLEGROUNDS: r/PUBATTLEGROUNDS
Planet Coaster 2: r/PlanetCoaster2
Factorio: Space Age: r/factorio
New World: Aeternum: r/newworldgame
ASTRONEER: Glitchwalkers: No subreddit found
Dota 2: r/DotA2
Overwatch® 2: r/overwatch2
Grand Theft Auto V: r/GrandTheftAutoV
Call of Duty®: Black Ops 6 - BlackCell (Season 01): r/blackops6
Phasmophobia: r/phasmophobia
ELDEN RING: r/Eldenring
Monster Hunter Wilds: r/MonsterHunterWilds
Yu-Gi-Oh! Master Duel: r/YuGiOhMasterDuel
Liar's Bar: r/LiarsBar
Tom Clancy's Rainbow Six® Siege: r/RainbowSixSiege
Warhammer: Vermintide 2: r/Vermintide
Age of Wonders 4: r/AOW4
Monster Hunter: World: r/MonsterHunterWorld
LEGO® Horizon Adventures™: r/legoHorizonZeroDawn
Call of Duty®: Black Ops 6 or Call of Duty®: Warzone™ Points: No subreddit found
Six Days in Fallujah: r/sixdaysinfallujah
The First Descendant: r/TheFirstDescendant
THE FINALS: r/thefinals
Stellaris: r/Stellaris
IdleOn - The Idle RPG: r/TheKingsArmyIdleRPG
Team Fortress 2: r/TeamFortress2
THRONE AND LIBERTY - Celebration Pack: Gold: r/GoldandBlack
EA SPORTS™ Madden NFL 25: r/MaddenMobileForums
Temtem: Swarm: r/PlayTemtem
Age of Empires II: Definitive Edition: r/aoe2
DayZ: r/dayz
Bodycam: r/bodycam
Arma 3: r/arma3
World of Warships: r/WorldOfWarships
Songs of Silence: r/songsofsilence
Borderlands 3: r/borderlands3
VRChat: r/VRchat
Stardew Valley: r/StardewValley
PlateUp!: r/PlateUp
Rivals of Aether II: r/RivalsOfAether
Crusader Kings III: r/CrusaderKings
Age of Empires II: DE - Chronicles: Battle for Greece: r/aoe2
Diablo® IV: r/diabloiv
Red Dead Redemption 2: r/reddeadredemption2
Satisfactory: r/satisfactory
ARK: Survival Ascended: r/ArkSurvivalAscended
American Truck Simulator: r/americantruck
MONSTER HUNTER RISE: r/MonsterHunter
Warhammer 40,000: Inquisitor - Martyr: r/40kinquisitor
MapleStory: r/Maplestory
Overcooked! 2: r/OvercookedGame
Arma Reforger: r/ArmaReforger
iRacing: r/iRacing
DEATH NOTE Killer Within: r/DeathNoteKillerWithin
STAR WARS™: The Old Republic™: r/swtor
Teenage Mutant Ninja Turtles: Splintered Fate: r/TMNT
Ready or Not: r/ReadyOrNotGame
Project Zomboid: r/projectzomboid
LOCKDOWN Protocol: r/LockdownProtocol
ICARUS: r/ICARUS
RuneScape ®: r/runescape
Homeworld 3: r/Homeworld3
Palworld: r/Palworld
Monster Hunter World: Iceborne: r/MonsterHunterWorld
Lethal Company: r/lethalcompany
theHunter: Call of the Wild™: r/Breath_of_the_Wild
Expansion - Hearts of Iron IV: Arms Against Tyranny: r/Fuhrerredux
